+-------------------------+
|^^^^^^ ` ` ` ` ` ` ` ` ` |
|^^^^ ` ` ` ` * * ` ` ` ` |
|^^^^ ` ` ` * * ` ` ` ` ` |
|^^^` ` ` ` ` ` ` ` ` ` ` |
| ` ` ` ` ~~~~~ ` ` ` ` ` |
| ` ` ` ` ~~~~~ ` ` ` ` ` |
| ` ` ` ~~~~~~~ ` ` ` ` ` |
| ` ` ` ` ` ~~~~~ ` ` ` ` |
| ` ` ` ` ` ~~~~~~~ ` ` ` |
| ` ` ` ` ` ` `~~ ` ` ` ` |
| ` ` ` ` ` ` ` ` ` ` ` ` |
| ` ` ` ` ` ` ` ` ` ` ` ` |
+-------------------------+